111111111111111111111111111111111111111111111111
1E0000000000000000000000000000000000000000000001
100000000000000000000000000000000000000000000001
100000000001111111111111110000000000000000000001
100000000001C00000000000010000000000000000000001
1C0000000001000000000000010000000000000000000001
111111111111111111110001110000000000000000000001
100000000000000000000000000000000000000000000001
100000000000000000000000000000001110000011100001
100000000001111111111111000000001000000000100001
100000000001111111111111000000001000000000100001
1P0000000000000000000001000000001000C00000100001
111111111111111111111111111111111111111111111111